.,.,.,.,.,.,.,.,.,.
.,#,.,.,.,.,.,.,.,.
.,#,.,.,.,.,#,#,#,#
.,.,.,.,.,.,#,.,.,.
.,.,.,.,.,.,#,.,.,.
.,.,#,.,.,.,.,.,.,.
.,.,#,.,.,.,#,.,#,#
.,.,.,.,.,.,#,.,.,.
.,.,.,.,.,.,#,.,.,.
.,.,.,.,.,.,#,.,.,.