#,#,#,#,#,#,#,#,#,#,#,#,#,#,#,#,#,#,#,#,#,#,#,#,#,#,#,#,#,#,#,#,#,#,#,#,#
#,#,#,.,.,.,.,.,.,.,.,.,.,.,.,#,#,#,#,#,#,#,#,#,#,#,#,#,#,#,#,#,#,#,#,#,#
#,#,#,.,.,.,.,.,.,.,.,.,.,.,.,#,#,#,#,#,#,#,#,#,#,#,#,#,#,#,#,#,#,#,#,#,#
#,#,#,.,.,.,.,.,.,.,.,.,.,.,.,#,#,#,#,#,#,#,#,#,#,#,#,#,#,#,#,#,#,#,#,#,#
#,#,#,.,.,.,.,.,.,.,.,.,.,.,.,#,#,#,#,#,#,#,#,#,#,#,#,#,#,#,#,#,#,#,#,#,#
#,#,#,.,.,.,.,.,.,.,.,.,.,.,.,#,#,#,#,#,#,#,#,#,#,#,#,#,#,#,#,#,#,#,#,#,#
#,#,#,#,#,.,.,.,.,.,.,.,.,.,.,.,.,.,.,.,.,#,#,#,#,#,#,#,#,#,#,#,#,#,#,#,#
#,#,#,#,#,.,.,.,.,.,.,.,.,.,.,.,.,.,.,.,.,#,#,#,#,#,#,#,#,#,#,#,#,#,#,#,#
#,#,#,#,#,.,.,.,.,.,.,.,.,.,.,.,.,.,.,.,.,#,#,#,#,#,#,#,#,#,#,#,#,#,#,#,#
#,#,#,#,#,.,.,.,.,.,.,.,.,.,.,.,.,.,.,.,.,#,#,#,#,#,#,#,#,#,#,#,#,#,#,#,#
#,#,#,#,#,#,#,#,#,#,#,#,#,.,.,#,#,#,#,#,#,#,#,#,#,#,#,#,#,#,#,#,#,#,#,#,#
#,.,.,.,.,.,.,.,.,.,.,.,#,.,.,.,.,.,.,.,#,#,#,#,#,#,#,.,.,.,.,.,#,#,#,#,#
#,.,.,.,.,.,.,.,.,.,.,.,#,.,.,.,.,.,.,.,#,#,#,#,#,#,#,.,.,.,.,.,#,#,#,#,#
#,.,.,.,.,.,.,.,.,.,.,.,.,.,.,.,.,.,.,.,#,#,#,#,#,#,#,.,.,.,.,.,#,#,#,#,#
#,.,.,.,.,.,.,.,.,.,.,.,.,.,.,.,.,.,.,.,#,#,#,#,#,#,#,#,.,.,.,#,#,.,.,.,#
#,.,.,.,.,.,.,.,.,.,.,.,#,.,.,.,.,.,.,.,#,#,#,#,#,#,#,.,.,.,.,.,.,.,.,.,#
#,#,#,#,.,.,.,.,.,.,.,.,#,.,.,.,.,.,.,.,.,.,.,.,.,.,.,.,.,.,.,.,.,.,.,.,#
#,#,#,#,#,#,#,#,#,#,#,#,#,.,.,.,.,.,.,.,.,.,.,.,.,.,.,.,.,.,.,.,.,.,.,.,#
#,#,#,#,.,.,.,.,.,.,.,.,.,.,.,.,.,.,.,.,.,.,.,.,.,.,.,.,.,.,.,.,.,.,.,.,#
#,#,#,#,.,.,.,.,.,.,.,.,.,.,.,.,.,.,.,.,.,.,.,.,#,#,#,.,.,.,.,.,.,.,.,.,#
#,#,#,#,.,.,.,.,.,.,.,.,#,.,.,#,#,#,#,#,#,#,.,.,.,.,#,.,.,.,.,.,.,.,.,.,#
#,#,#,#,.,.,.,.,.,.,.,.,#,.,.,.,.,.,.,.,.,#,.,.,.,.,#,.,.,.,.,.,.,.,.,.,#
#,#,#,#,.,.,.,.,.,.,.,.,#,.,.,.,.,.,.,.,.,#,.,.,.,.,#,.,.,.,.,.,.,.,.,.,#
#,#,#,#,.,.,.,.,.,.,.,.,#,.,.,.,.,.,.,.,.,#,.,.,.,.,#,.,.,.,.,.,.,.,.,.,#
#,#,#,#,.,.,.,.,.,.,.,.,#,.,.,.,.,.,.,.,.,#,.,.,.,.,#,.,.,.,.,.,.,.,.,.,#
#,#,#,#,.,.,.,.,.,.,.,.,#,.,.,.,.,.,.,.,.,#,.,.,.,.,#,.,.,.,.,.,.,.,.,.,#
#,#,#,#,.,.,.,.,.,.,.,.,#,.,.,.,.,.,.,.,.,#,.,.,.,.,#,.,.,.,.,.,.,.,.,.,#
#,#,#,#,.,.,.,.,.,.,.,.,#,.,.,.,.,.,.,.,.,#,.,.,.,.,#,.,.,.,.,.,.,.,.,.,#
#,#,#,#,.,.,.,.,.,.,.,.,#,.,.,.,.,.,.,.,.,#,.,.,.,.,#,.,.,.,.,.,.,.,.,.,#
#,#,#,#,#,#,.,.,.,.,.,.,#,.,.,.,.,.,.,.,.,#,.,.,.,.,#,.,.,.,.,.,.,.,.,.,#
#,#,#,#,#,#,#,#,#,#,#,#,#,#,#,#,#,#,#,#,#,#,#,#,#,#,#,#,#,#,#,#,#,#,#,#,#