.,.,.,.,.,.,.,.,.,.
.,#,.,.,.,.,.,.,.,.
.,#,.,.,.,.,.,.,.,.
.,.,.,.,.,.,.,.,.,.
.,.,.,.,.,.,#,.,.,.
.,.,#,.,.,.,.,.,.,.
.,.,#,.,.,.,.,.,.,.
.,.,.,.,.,.,.,.,.,.
.,.,.,.,.,.,.,.,.,.
.,.,.,.,.,.,.,.,.,.