.,.,.,.,#,.,.,.,.,.
.,.,#,#,#,.,.,.,.,.
.,.,.,.,.,.,#,#,#,#
#,.,.,.,.,.,#,.,.,.
#,.,.,.,.,.,#,.,.,.
#,.,.,.,.,.,.,.,.,.
#,.,.,.,.,.,#,#,#,#
.,.,.,.,.,.,.,.,.,.
.,.,.,.,.,.,#,.,.,.
.,.,.,.,.,.,#,.,.,.